wwwwwwwwwwwwwwwwwwwwwwwwwwwwww
w--------------w-------------w
w--------------w------d---t--w
w--------e----wwwwwww-d------w
w-------------w---------d----w
w-------d--w--w--------------w
w----------w---p-------------w
w----t-----w-----------------w
w-------d--w------------e----w
w---wwwwwwww---------wwwwwwwww
w----------w---dd----w-------w
w----e-----------------------w
w------------------------t---w
wwwwwwwwwwwwwwwwwwwwwwwwwwwwww