wwwwwwwwwwwwwwwwwwwwwwwwwwwwww
w----------------------------w
w----t---------w-------------w
w--------e-------------------w
w----e--------wwwwww----d----w
w-------d-----w---t----------w
w-------------w-----------e--w
w-------------w---dd---------w
w-------d-----w---dd----e----w
w----t--------w---dd---------w
w----wwwwwwwwww---------p----w
w--e----------------e--------w
w----------------------------w
wwwwwwwwwwwwwwwwwwwwwwwwwwwwww