wwwwwwwwwwwwwwwwwwwwwwwwwwwwww
w-------t--------------------w
w---e-----------------d------w
w--------e----wwwwwww--------w
w-------------w-----w---d----w
w--dddddd-----w-----w--------w
w-------------------w-----t--w
w----------e--------w--------w
w-----------------------e----w
w--e--ddw--------------------w
w-----ddw------d-----wwwwwwwww
w--t----w---e----------------w
w-------w--------------p-----w
wwwwwwwwwwwwwwwwwwwwwwwwwwwwww