wwwwwwwwwwwwwwwwwwwwwwwwwwwwww
w-------wwww---w-------------w
w---------ww---w------d----t-w
w--------e----wwwwwww--------w
w--------t----w---------d----w
w-----------www------e-------w
w---wwwwwwwww--p-------------w
w----------------------------w
w-----------------------e----w
w--------e-------------------w
w--------ddddddd-----wwwwwwwww
w----e----t---www------------w
w----------------------------w
wwwwwwwwwwwwwwwwwwwwwwwwwwwwww