wwwwwwwwwwwwwwwwwwwwwwwwwwwwww
w-------d------w-------------w
w---t---d------w------d------w
w--------e----wwwwwww--------w
w---e---------w---------d----w
w-------d-----w------wwwww---w
w--------------p-----w--t----w
w----t---------------w-------w
w-------d------d-----w--e----w
w--------------d-----w-------w
w-----------e--d-----wwwww---w
w----e-----------------------w
w----------------------------w
wwwwwwwwwwwwwwwwwwwwwwwwwwwwww